###############
#             #
# ########### #
# #           #
# #############
#             #
############# #
#.$@          #
###############