###############
#             #
# ########### #
# #           #
# # ###########
# #           #
# #############
#          @$.#
###############