#######
#   . #
#  $$ #
#   @ #
#######