#############
#    . @    #
#      $    #
#           #
#############