               ####
###############    #
#                  #
# ##############   #
# #              @ #
# # ############## #
# # #            # #
# # # ########## # #
# # # #        # # #
# # # # ###### # # #
# # # # #    # # # #
# # # #      # # # #
# # # ######## # # #
# # #          # # #
# # ############ # #
#$#              # #
#.################ #
#.$                #
####################