###########################
#                          #
#       $        $        .#
#                          #
#     ######################
#                          #
#                          #
#                          #
#     ######################
#                          #
# @                        #
#                          #
#     ######################
#                          #
#                          #
#                          #
#     ######################
#                          #
# .                        #
#                          #
############################