#########
#@      #
#  $    #
#  ###  #
#  ###  #
#  ###  #
#  ###  #
#     . #
#       #
#########
