#################
#               #
#     $  $     .#
#   #           #
#   #############
#               #
#               #
#   #           #
#   #############
#               #
# @             #
#   #           #
#   #############
#               #
#               #
#   #           #
#   #############
#               #
# .             #
#               #
#################