############################
#                          #
#       $        $        .#
#     #                    #
#     ######################
#                          #
#                          #
#     #                    #
#     ######################
#                          #
# @                        #
#     #                    #
#     ######################
#                          #
#                          #
#     #                    #
#     ######################
#                          #
# .                        #
#                          #
############################