####################
#                  #
#                  #
#                  #
#                  #
#                  #
#                  #
#                  #
#   .$             #
#         @        #
#                  #
#                  #
#                  #
#                  #
#                  #
#                  #
#                  #
#                  #
#                  #
####################