#######
#  @  #
# $$$ #
#     #
### ###
### ###
### ###
#     #
# ... #
#     #
#     #
#######