######################
####   ###############
#### # ###############
#### #  #   #   ######
#       # $   $ ######
# ## #$ #   #   #   ##
# $  #  ## ## $   $ ##
# ## #####  #   #   ##
# $   #  #  ###### ###
### $    @  ...# # ###
###   #     ...# # ###
#######  ###...# # ###
################ #   #
################## $ #
##################   #
######################