     ###############
     #######.#######
     ###### . ######
     ##           ##
     #   # # # #   #
     #  ##     ##  #
##########     ##  #
#          $@$     #
#           #      #
####################