 ###############
 #  #          #
 #  # #        #
 #     #       #
###     #      #
# #      #     #
#  #  @$  #$   #
#    ##        #
 #  ##    #   .#
  #  #.   #     #
   #  # ##      #
    #############