#######
#.    #
#     #
#     #
# $ # #
#    @#
#######