#######
#  #@ #
#  ## #
# .   #
# $ # #
#     #
#######